00000000000000000000
00010010101000100010
00000000000010000000
00010000000000000000
00000100000100001000
01010000100000000000
00000000000000000010
01010100010000000000
00000000000101001000
00001000100000000000
00000010000001000000
01000000000000001010
00000100000000000000
00000000100000000000
00010100000100000000
00000000100000000000
01000000000010001000
00000000100000000000
00101010000100010000
00000000000000000000
