11111111111111111111
12000000010001010001
10110101010100010101
10100104010011110101
10101001011000000101
10001010001101111101
11111040100000000001
10001000001111101111
10101111111000100001
10100400000010111101
10110001010110000101
10001011010011110001
11100000011000011111
10101111000011000001
10000000111001110101
10101010000100010101
10101001110001000101
10100100001110111101
10010001100000000031
11111111111111111111
