1111111111
1000000000
1011111111
1010000001
1010111101
1010100101
1010000101
1011111101
1000000001
1111111111
