11111111111111111111
12110011111111110111
10010401111111100011
11011101010001141011
11011100050101101001
11000111111105001111
11415111111001100111
11000101110011110111
11011101100111000111
11001151101100010011
11100101001151111411
11110101011101111001
13110000010000001141
10011101110111111001
11011100100111110011
11001101101104000111
11100101101001001101
11110500000011101101
11111111111111104001
11111111111111111111
